"a" = (/turf/grass,/area)
"b" = (/turf/dirt,/area)

(1,1,1) = {"
aaaaaaaaaa
aaaaaaaaba
aabaaaaaaa
aabaaaaaaa
aaaaaaaaaa
aaaaaabaaa
aaaaaaaaaa
abaabaabaa
aaaaaaaaaa
aaaaaaaaaa
"}
