"a" = (/turf/Wall,/area)
"b" = (/turf/Grass,/area)
"c" = (/mob/Enemy,/turf/Grass,/area)
"d" = (/mob/Friendly,/turf/Grass,/area)

(1,1,1) = {"
aaaaaaaaaaaaaaaaaaaaaaaaaaaaaaaaaaaaaaaaaaaaaaaaaa
abbbbbbbbbbbbbbbbbbbbbbbbbbbbbbbbbbbbbbbbbbbbbbbba
abbcbbbbbbbbbbbbbbbbbbbbbbbbbbbbbbbbbbbbbbbbbbbbba
abbbbbbbbbbbbbaaaaaaaabbbbbbbcbbbbbbbbbbbbbbbbbbba
abbabbbabbbbbbbbbbbbbabbbbbbbbbbbbbbbbbbbbbbbbbbba
abbabbbabbbbbbbbbbbbbabbbbbbbbbbbbbbbbbbbbbbbbbbba
abbabbbabbbbbbbbcbbbbabbbbbaaaaaaaaaaaaaaaaabbbbba
abbabbbbbbbbbbbbbbbbbabbcbbbbabbbbbbbbbabbbbbbbbba
abbaaaaaaaaaaaaabbbbbabbbbbbbabbbbdbbbbabbbbbbbbba
abbabbbbbbbbbbbbbbbbbabbbbbbbabbbbbbbbbabbbbbbbbba
abbabbbbbbbcbbbbbbbbbadbbbbbbabbbbbbbbbabbbbbbbbba
abbabbbbbbbbbbbdbbbbbabbbbbbbabbbbcbbbbabbbbbbbbba
abbaaaaaaaaabbbbbbbbbbbbbbbbbabbbbbbbbbabbbcbbbbba
abbbbcbbbbbbbbbbaaaaaaaaabbbbabbbbabbbbabbbbabbbba
abbbbbbbbbbbbbbbbbbabbbbbbbbbbbbbbabbbbabbbbabbbba
abbbbbbbbbbbbbbbbbbabbbbbbbbbbbbbbabbbbbbbdbabbbba
abbaaaaaaaaabbbbbbbabbbbbbbbbbbbbbabbbbbbbbbabbbba
abbabbbbbbbbbbabbbbabbbbbbbcbbbbbbabbbbbbbbbabbbba
abbabbbbbbbbbbabbbbabbbbbbbbbbbaaaaaaaaaaaaaaaaaba
abbbbbbbbbbbbbabcbbabbbbbbbbbbbbbbbbbbbbbbbbbbbbba
abbbbbdbbbbbbbabbbbabbbbbbbbbbbbbbbbbbbbbbbbbdbbba
abbbbbbbbbbbbbabbbbbbbbbbabbbbbbbbbbbbbbbbbbbbbbba
abbbbaaaaaabbbabbbbbbbbbbabbbbbdbbbbbbbbbbabbbbbba
abbbbbbbbbabbbabbbbbbbbbbabbbbbbbbbbbbbbbbabbbbbba
abbbbbbbbbabbbabbbbbcbbbbabbbbbbbbbbbbbcbbabbbbbba
abbbbbbbbbabbbabbbbbbbbbbaaaaaaaabbbbbbbbbaaaaaaaa
aaaaaaacbbabbbabbbbbbbbbbabbbbbbbbbbbbbbbbbbbbbbba
abbbbbbbbbabbbabbbbbbbbbbabbbbbbbbbbbbbbbbbbbbbbba
abbbbbbbbbabbbabbbbabbbbbabbbbbcbbbaaaaaaaabbbbbba
abbbbbbbbbabbbabbbbabbbbbabbbbbbbbbbbbbbbbbbbbbbba
abbbaaaaaaabbbbbbbbabbbbbabbbbbbbbbbbbbbbbbbbbbbba
abbbbbbbbbabbbbbbbbabbbbbabbbbbbbbbbbbbbbdbbbbbbba
abbbbbbbbbabbbdbbbbabbbbbabbbbbbbbbbbbbbbbaaaaaaaa
abbabbbbbbabbbbbbbbabbbbbabbbbbbbbbbbbbbbbabbbbbba
abbabbbbbbabbbbaaaaabbbbbbbbbaaaaaaaaaaaaaabbbdbba
abbabbbbbbbbbbbbbbbbbbbbbbbbbbbbbbabbbbbbabbbbbbba
abbaaaabbbbbbbbcbbbbbbbbbbbbbbbbbbabbbbbbabbbbbbba
abbabbbbbbbbbbbbbbbbbbbbbcbbbbbbbbabbbbbbabbbbbbba
abbabbbbbbbbbbbbbbbbbbbbbbbbbbbdbbabbbbbbabbbbbbba
abbabbbbbbbbbbbbbbbbbbbbbbbbabbbbbabbbbbbabbbbbbba
abbabbbbaaaaaaaaaaaaabbbbbbbabbbbbabbbbbbbbbbbbbba
abbabbcbbbbbbbbbbbbbbbbbbbbbabbbbbbbbbbbbbcbbbbbba
abbabbbbbbbbbbbbbbbbbbbbbbbbabbbcbbbbbbbbbbbbbbbba
abbabbbbbbbbbbbbbbbbbbbdbbbbabbbbbbbbbbbbbbbbbbbba
abbabbbbbbbbbbbbbbbbbbbbaaaaaaaaaaaaaaaaaaaaabbbba
abbaaaaaaaaaaaaaaaabbbbbbbbbbbbbbbdbbbbbbbbbbbbbba
abbabbbbbbbbbbbbbbbbbbbbbbbbbbbbbbbbbbbbbbbbbbbbba
abbabbdbbbbbbbbbbbbbbcbbbbbbbbbbbbbbbbbbbbcbbbbbba
abbabbbbbbbbbbbbbbbbbbbbbbbbbbbbbbabbbbbbbbbbbbbba
aaaaaaaaaaaaaaaaaaaaaaaaaaaaaaaaaaaaaaaaaaaaaaaaaa
"}
